111111111111111111111111111
1E1111111111111C11111C11111
101110000000000000001111111
100000000000000000000111111
1P0000001C11C1C111111111111
111111111111111111111111111