111111111111111111111111111
1P00000E000000C00000C000011
10000000000000000000000001
111111111111111111111111111